NO                      ./textures/wall1.png

C                    0,0,26

SO ./textures/wall2.png

WE     ./textures/wall3.png

EA                   ./textures/wall4.png

F           153,77,0


1111111111111111111111111111111111111111
1001100000110000000100000000110000000001
10111110011100000000011111001110000000N1
10100010010001110001010001000011000000001
10000000110000011101000000000011110011001
1111011111011101110101111101101111011100
1111011111011101110101111101101111101111
10000000000001011101011111111000000011101
1111111111111111111111111111111111111111
