NO                      ./textures/wall1.png

C                    0,0,26

SO ./textures/wall2.png

WE     ./textures/wall3.png

EA                   ./textures/wall4.png

F           153,77,0


1111111111111111111111111111111111111111
1001100000110000000100000000110000000001
1011111001110000000001111100111000000001
1010001001000111000101000100001100000001
10000111101101010111010111110110101011001
1000000011N000011101000000000011110011001
11110111110111011101011111011011111011101
11110111110111011101011111011011111011101
11000110110101011101000000001011111011101
10000000000001011101011111111000000011101
1111111111111111111111111111111111111111